"filename", "language", "Dart", "comment", "blank", "total"
"c:\dev\blookly_app\lib\constants.dart", "Dart", 4, 0, 2, 6
"c:\dev\blookly_app\lib\core\utils\app_router.dart", "Dart", 24, 0, 2, 26
"c:\dev\blookly_app\lib\core\utils\assets.dart", "Dart", 4, 0, 1, 5
"c:\dev\blookly_app\lib\core\utils\styles.dart", "Dart", 25, 0, 2, 27
"c:\dev\blookly_app\lib\feature\home\presentation\view\books_details_view.dart", "Dart", 8, 0, 3, 11
"c:\dev\blookly_app\lib\feature\home\presentation\view\home_view.dart", "Dart", 11, 0, 3, 14
"c:\dev\blookly_app\lib\feature\home\presentation\view\widgets\best_seller_list_view.dart", "Dart", 19, 0, 3, 22
"c:\dev\blookly_app\lib\feature\home\presentation\view\widgets\best_seller_list_view_item.dart", "Dart", 78, 0, 3, 81
"c:\dev\blookly_app\lib\feature\home\presentation\view\widgets\book_rating.dart", "Dart", 31, 0, 3, 34
"c:\dev\blookly_app\lib\feature\home\presentation\view\widgets\custom_app_bar.dart", "Dart", 28, 0, 3, 31
"c:\dev\blookly_app\lib\feature\home\presentation\view\widgets\feature_list_view.item.dart", "Dart", 19, 0, 3, 22
"c:\dev\blookly_app\lib\feature\home\presentation\view\widgets\featured_list_view.dart", "Dart", 19, 0, 3, 22
"c:\dev\blookly_app\lib\feature\home\presentation\view\widgets\home_view_body.dart", "Dart", 46, 0, 3, 49
"c:\dev\blookly_app\lib\feature\splash\presentation\views\splash_view.dart", "Dart", 11, 0, 3, 14
"c:\dev\blookly_app\lib\feature\splash\presentation\views\widgets\sliding_text.dart", "Dart", 23, 0, 4, 27
"c:\dev\blookly_app\lib\feature\splash\presentation\views\widgets\splash_view_body.dart", "Dart", 55, 5, 10, 70
"c:\dev\blookly_app\lib\main.dart", "Dart", 21, 0, 4, 25
"Total", "-", 426, 5, 55, 486